{
	"1001": {
		"mapId": 1001,
		"mapName": "第一关",
		"startStage": 9999,
		"stageList": {
			"9999": {
				"stageid": 9999,
				"resid": 9999,
				"width": 640,
				"height": 1920,
				"grid_width": 40,
				"grid_height": 40,
				"rows": 48,
				"lines": 16,
				"name": "测试场景1",
				"startPos": {
					"x": 8,
					"y": 5
				},
				"trancePos": [{
					"tomap": 9998,
					"x": 8,
					"y": 45
				}],
				"mapInfo": [
					[0, 0, 1, 1, 1, 1, 1, 1, 1, 0, 0, 0, 0, 2, 2, 2],
					[0, 0, 0, 1, 1, 1, 1, 1, 1, 0, 0, 0, 0, 0, 0, 2],
					[0, 0, 1, 1, 1, 1, 1, 1, 1, 0, 0, 0, 1, 0, 0, 0],
					[0, 0, 1, 1, 1, 1, 1, 1, 1, 0, 0, 0, 0, 0, 0, 0],
					[2, 2, 1, 1, 1, 1, 1, 1, 1, 0, 0, 0, 0, 0, 0, 0],
					[2, 2, 1, 1, 1, 1, 1, 1, 1, 1, 0, 0, 0, 0, 0, 0],
					[2, 2, 1, 1, 1, 1, 1, 1, 1, 2, 2, 2, 2, 2, 2, 2],
					[2, 1, 1, 1, 1, 1, 1, 1, 1, 2, 2, 2, 2, 2, 2, 2],
					[2, 1, 1, 1, 1, 1, 1, 1, 1, 2, 2, 2, 2, 2, 2, 2],
					[2, 2, 1, 1, 1, 1, 1, 1, 1, 1, 2, 2, 2, 2, 2, 2],
					[2, 2, 1, 1, 1, 1, 1, 1, 1, 1, 2, 2, 2, 2, 2, 2],
					[2, 2, 2, 1, 1, 1, 1, 1, 1, 1, 1, 2, 2, 2, 2, 2],
					[2, 2, 0, 0, 1, 1, 1, 1, 1, 1, 1, 1, 1, 2, 2, 2],
					[2, 2, 0, 0, 1, 1, 1, 1, 1, 1, 1, 1, 2, 2, 2, 2],
					[0, 0, 0, 0, 0, 1, 1, 1, 1, 1, 1, 2, 2, 2, 2, 2],
					[0, 0, 0, 0, 0, 0, 1, 1, 1, 1, 1, 2, 2, 2, 2, 2],
					[2, 0, 0, 0, 0, 0, 0, 2, 2, 1, 1, 2, 2, 2, 2, 2],
					[2, 0, 0, 0, 0, 0, 0, 1, 1, 1, 2, 2, 2, 2, 2, 2],
					[2, 0, 0, 0, 0, 0, 0, 1, 1, 1, 1, 1, 2, 1, 1, 2],
					[2, 0, 0, 0, 0, 0, 0, 1, 1, 1, 1, 1, 1, 1, 1, 2],
					[2, 2, 0, 0, 0, 0, 2, 2, 1, 1, 1, 1, 1, 2, 2, 2],
					[2, 2, 2, 0, 0, 0, 2, 2, 1, 1, 1, 1, 1, 2, 1, 2],
					[2, 2, 2, 2, 2, 2, 2, 2, 1, 1, 1, 1, 1, 2, 2, 2],
					[2, 2, 2, 2, 2, 2, 2, 1, 1, 1, 1, 1, 1, 2, 2, 2],
					[2, 2, 2, 2, 2, 2, 1, 1, 1, 1, 1, 1, 1, 2, 2, 2],
					[1, 1, 1, 1, 1, 1, 1, 1, 1, 1, 1, 1, 1, 2, 2, 2],
					[1, 1, 1, 1, 1, 1, 1, 1, 1, 1, 1, 1, 1, 1, 2, 2],
					[1, 1, 1, 1, 1, 1, 1, 1, 1, 1, 1, 1, 1, 1, 2, 2],
					[1, 1, 1, 1, 1, 1, 1, 1, 1, 1, 1, 1, 1, 2, 2, 2],
					[0, 1, 1, 1, 1, 1, 1, 1, 1, 1, 1, 0, 0, 0, 2, 2],
					[0, 1, 1, 1, 1, 2, 2, 1, 1, 1, 1, 0, 0, 0, 2, 2],
					[2, 2, 1, 1, 1, 2, 2, 1, 1, 1, 1, 0, 0, 2, 2, 2],
					[2, 2, 2, 2, 2, 2, 2, 2, 2, 1, 1, 1, 1, 2, 2, 2],
					[2, 2, 2, 2, 2, 2, 2, 2, 2, 1, 1, 1, 1, 1, 1, 1],
					[2, 2, 2, 2, 2, 2, 2, 2, 2, 1, 1, 1, 1, 1, 1, 1],
					[2, 2, 2, 2, 2, 2, 2, 2, 2, 1, 1, 1, 1, 1, 1, 2],
					[2, 2, 2, 2, 2, 2, 2, 2, 2, 1, 1, 1, 1, 1, 0, 0],
					[2, 2, 2, 2, 2, 2, 2, 0, 0, 0, 1, 1, 1, 1, 0, 0],
					[2, 2, 2, 2, 2, 2, 2, 0, 0, 0, 1, 1, 1, 1, 1, 2],
					[0, 0, 0, 2, 2, 2, 2, 0, 0, 0, 1, 1, 1, 1, 1, 2],
					[0, 0, 0, 1, 0, 2, 2, 0, 0, 1, 1, 1, 1, 1, 2, 2],
					[0, 0, 0, 0, 0, 0, 2, 1, 1, 1, 1, 1, 1, 0, 2, 2],
					[0, 0, 0, 0, 0, 0, 2, 1, 1, 1, 1, 1, 0, 0, 0, 2],
					[2, 2, 2, 2, 2, 2, 2, 1, 1, 1, 1, 1, 0, 0, 0, 2],
					[2, 2, 2, 2, 2, 2, 1, 1, 1, 1, 1, 0, 0, 0, 0, 2],
					[2, 2, 2, 2, 2, 1, 1, 1, 1, 1, 1, 0, 0, 0, 0, 2],
					[1, 1, 1, 1, 1, 1, 1, 1, 1, 1, 1, 0, 0, 0, 0, 2],
					[1, 1, 1, 1, 1, 1, 1, 1, 1, 1, 1, 2, 2, 2, 2, 2]
				]
			},
			"9998": {
				"stageid": 9998,
				"resid": 9999,
				"height": 1920,
				"grid_width": 40,
				"grid_height": 40,
				"rows": 48,
				"lines": 16,
				"name": "测试场景2",
				"startPos": {
					"x": 5,
					"y": 8
				},
				"trancePos": [{
					"tomap": 9999,
					"x": 30,
					"y": 29
				}],
				"mapInfo": [
					[0, 0, 1, 1, 1, 1, 1, 1, 1, 0, 0, 0, 0, 2, 2, 2],
					[0, 0, 0, 1, 1, 1, 1, 1, 1, 0, 0, 0, 0, 0, 0, 2],
					[0, 0, 1, 1, 1, 1, 1, 1, 1, 0, 0, 0, 1, 0, 0, 0],
					[0, 0, 1, 1, 1, 1, 1, 1, 1, 0, 0, 0, 0, 0, 0, 0],
					[2, 2, 1, 1, 1, 1, 1, 1, 1, 0, 0, 0, 0, 0, 0, 0],
					[2, 2, 1, 1, 1, 1, 1, 1, 1, 1, 0, 0, 0, 0, 0, 0],
					[2, 2, 1, 1, 1, 1, 1, 1, 1, 2, 2, 2, 2, 2, 2, 2],
					[2, 1, 1, 1, 1, 1, 1, 1, 1, 2, 2, 2, 2, 2, 2, 2],
					[2, 1, 1, 1, 1, 1, 1, 1, 1, 2, 2, 2, 2, 2, 2, 2],
					[2, 2, 1, 1, 1, 1, 1, 1, 1, 1, 2, 2, 2, 2, 2, 2],
					[2, 2, 1, 1, 1, 1, 1, 1, 1, 1, 2, 2, 2, 2, 2, 2],
					[2, 2, 2, 1, 1, 1, 1, 1, 1, 1, 1, 2, 2, 2, 2, 2],
					[2, 2, 0, 0, 1, 1, 1, 1, 1, 1, 1, 1, 1, 2, 2, 2],
					[2, 2, 0, 0, 1, 1, 1, 1, 1, 1, 1, 1, 2, 2, 2, 2],
					[0, 0, 0, 0, 0, 1, 1, 1, 1, 1, 1, 2, 2, 2, 2, 2],
					[0, 0, 0, 0, 0, 0, 1, 1, 1, 1, 1, 2, 2, 2, 2, 2],
					[2, 0, 0, 0, 0, 0, 0, 2, 2, 1, 1, 2, 2, 2, 2, 2],
					[2, 0, 0, 0, 0, 0, 0, 1, 1, 1, 2, 2, 2, 2, 2, 2],
					[2, 0, 0, 0, 0, 0, 0, 1, 1, 1, 1, 1, 2, 1, 1, 2],
					[2, 0, 0, 0, 0, 0, 0, 1, 1, 1, 1, 1, 1, 1, 1, 2],
					[2, 2, 0, 0, 0, 0, 2, 2, 1, 1, 1, 1, 1, 2, 2, 2],
					[2, 2, 2, 0, 0, 0, 2, 2, 1, 1, 1, 1, 1, 2, 1, 2],
					[2, 2, 2, 2, 2, 2, 2, 2, 1, 1, 1, 1, 1, 2, 2, 2],
					[2, 2, 2, 2, 2, 2, 2, 1, 1, 1, 1, 1, 1, 2, 2, 2],
					[2, 2, 2, 2, 2, 2, 1, 1, 1, 1, 1, 1, 1, 2, 2, 2],
					[1, 1, 1, 1, 1, 1, 1, 1, 1, 1, 1, 1, 1, 2, 2, 2],
					[1, 1, 1, 1, 1, 1, 1, 1, 1, 1, 1, 1, 1, 1, 2, 2],
					[1, 1, 1, 1, 1, 1, 1, 1, 1, 1, 1, 1, 1, 1, 2, 2],
					[1, 1, 1, 1, 1, 1, 1, 1, 1, 1, 1, 1, 1, 2, 2, 2],
					[0, 1, 1, 1, 1, 1, 1, 1, 1, 1, 1, 0, 0, 0, 2, 2],
					[0, 1, 1, 1, 1, 2, 2, 1, 1, 1, 1, 0, 0, 0, 2, 2],
					[2, 2, 1, 1, 1, 2, 2, 1, 1, 1, 1, 0, 0, 2, 2, 2],
					[2, 2, 2, 2, 2, 2, 2, 2, 2, 1, 1, 1, 1, 2, 2, 2],
					[2, 2, 2, 2, 2, 2, 2, 2, 2, 1, 1, 1, 1, 1, 1, 1],
					[2, 2, 2, 2, 2, 2, 2, 2, 2, 1, 1, 1, 1, 1, 1, 1],
					[2, 2, 2, 2, 2, 2, 2, 2, 2, 1, 1, 1, 1, 1, 1, 2],
					[2, 2, 2, 2, 2, 2, 2, 2, 2, 1, 1, 1, 1, 1, 0, 0],
					[2, 2, 2, 2, 2, 2, 2, 0, 0, 0, 1, 1, 1, 1, 0, 0],
					[2, 2, 2, 2, 2, 2, 2, 0, 0, 0, 1, 1, 1, 1, 1, 2],
					[0, 0, 0, 2, 2, 2, 2, 0, 0, 0, 1, 1, 1, 1, 1, 2],
					[0, 0, 0, 1, 0, 2, 2, 0, 0, 1, 1, 1, 1, 1, 2, 2],
					[0, 0, 0, 0, 0, 0, 2, 1, 1, 1, 1, 1, 1, 0, 2, 2],
					[0, 0, 0, 0, 0, 0, 2, 1, 1, 1, 1, 1, 0, 0, 0, 2],
					[2, 2, 2, 2, 2, 2, 2, 1, 1, 1, 1, 1, 0, 0, 0, 2],
					[2, 2, 2, 2, 2, 2, 1, 1, 1, 1, 1, 0, 0, 0, 0, 2],
					[2, 2, 2, 2, 2, 1, 1, 1, 1, 1, 1, 0, 0, 0, 0, 2],
					[1, 1, 1, 1, 1, 1, 1, 1, 1, 1, 1, 0, 0, 0, 0, 2],
					[1, 1, 1, 1, 1, 1, 1, 1, 1, 1, 1, 2, 2, 2, 2, 2]
				]
			}
		}

	}

}